1 1 1 1 1 1 1 1 1 1 1 1 1 1 1 1 1 1 1 1 1 1 1 1 1 1 1 1 1 1 1 1 1 1 1 1 1 1 1 1 1 1 1 1 1 1 1 1 1 1
1 1 1 1 1 1 1 1 1 1 1 1 1 1 1 1 1 1 1 1 1 1 1 1 1 1 1 1 1 1 1 1 1 1 1 1 1 1 1 1 1 1 1 1 1 1 1 1 1 1
1 1 1 1 1 1 1 1 1 1 1 1 1 1 1 1 1 1 1 1 1 1 1 1 1 1 1 1 1 1 1 1 1 1 1 1 1 1 1 1 1 1 1 1 1 1 1 1 1 1
1 1 1 1 1 1 1 1 1 1 1 1 1 1 1 1 1 1 1 1 1 1 1 1 1 1 1 1 1 1 1 1 1 1 1 1 1 1 1 1 1 1 1 1 1 1 1 1 1 1
1 1 1 1 1 1 1 1 1 1 1 1 1 1 1 1 1 1 1 1 1 1 1 1 1 1 1 1 1 1 1 1 1 1 1 1 1 1 1 1 1 1 1 1 1 1 1 1 1 1
1 1 1 1 1 1 1 1 1 1 1 1 1 1 1 1 1 1 1 1 1 1 1 1 1 1 1 1 1 1 1 1 1 1 1 1 1 1 1 1 1 1 1 1 1 1 1 1 1 1
1 1 1 1 1 1 1 1 1 1 1 1 1 1 1 1 1 1 1 1 1 1 1 1 1 1 1 1 1 1 1 1 1 1 1 1 1 1 1 1 1 1 1 1 1 1 1 1 1 1
1 1 1 1 1 1 1 1 247 252 252 252 252 252 252 252 252 252 252 252 252 252 252 252 252 252 252 252 252 252 252 252 252 252 252 252 252 252 252 252 248 1 1 1 1 1 1 1 1 1
1 1 1 1 1 1 1 1 250 23 23 23 23 23 23 23 23 23 23 23 23 23 23 23 23 23 23 23 23 23 23 23 23 23 23 23 23 23 23 23 251 1 1 1 1 1 1 1 1 1
1 1 1 1 1 1 1 1 250 238 24 24 24 24 24 24 24 24 24 24 24 24 24 24 24 24 24 24 24 24 24 24 24 24 24 24 24 24 24 238 251 1 1 1 1 1 1 1 1 1
1 1 1 1 1 1 1 1 250 238 0 5 5 5 5 5 5 0 0 0 0 0 0 0 0 0 0 0 0 0 0 0 0 0 0 0 0 0 0 238 251 1 1 1 1 1 1 1 1 1
1 1 1 1 1 1 1 1 250 238 5 5 5 5 5 5 0 0 0 0 0 0 0 0 0 0 0 0 0 0 0 0 0 0 0 0 0 0 0 238 251 1 1 1 1 1 1 1 1 1
1 1 1 1 1 1 1 1 250 238 5 5 5 5 5 0 0 0 0 0 0 0 0 0 0 0 0 0 0 0 0 0 0 0 0 0 0 0 0 238 251 1 1 1 1 1 1 1 1 1
1 1 1 1 1 1 1 1 250 238 5 5 5 5 0 0 0 0 0 0 0 0 0 0 0 0 0 0 0 0 0 0 0 0 0 0 0 0 0 238 251 1 1 1 1 1 1 1 1 1
1 1 1 1 1 1 1 1 250 238 5 5 5 0 0 0 0 0 0 5 5 5 5 5 5 5 0 0 0 0 0 0 0 0 0 0 0 0 0 238 251 1 1 1 1 1 1 1 1 1
1 1 1 1 1 1 1 1 250 238 5 5 0 0 0 0 0 0 0 5 5 5 5 5 5 5 0 0 0 0 0 0 0 0 0 0 0 0 0 238 251 1 1 1 1 1 1 1 1 1
1 1 1 1 1 1 1 1 250 238 5 0 0 0 0 0 0 0 0 5 5 5 5 5 5 5 0 0 0 0 0 0 0 0 0 0 5 5 5 238 251 1 1 1 1 1 1 1 1 1
1 1 1 1 1 1 1 1 250 238 0 0 0 0 0 0 0 0 0 5 5 5 5 5 5 5 0 0 0 0 0 0 0 0 0 0 5 5 5 238 251 1 1 1 1 1 1 1 1 1
1 1 1 1 1 1 1 1 250 238 0 0 0 0 0 0 0 0 0 5 5 5 5 5 5 5 0 0 0 0 0 0 0 0 0 0 5 5 5 238 251 1 1 1 1 1 1 1 1 1
1 1 1 1 1 1 1 1 250 238 0 0 0 0 242 64 64 64 64 64 64 64 64 64 64 64 64 64 64 64 64 64 64 64 64 64 64 64 64 238 251 1 1 1 1 1 1 1 1 1
1 1 1 1 1 1 1 1 250 238 0 0 0 0 0 5 5 5 5 5 5 0 0 0 0 5 5 5 5 254 253 253 253 253 253 253 253 253 255 238 251 1 1 1 1 1 1 1 1 1
1 1 1 1 1 1 1 1 250 238 0 0 0 0 0 5 5 5 5 5 5 0 0 0 0 5 5 5 5 251 1 1 1 1 1 1 1 1 250 238 251 1 1 1 1 1 1 1 1 1
1 1 1 1 1 1 1 1 250 238 0 0 0 0 0 5 5 5 5 5 5 0 0 0 0 5 5 5 5 251 1 1 1 1 1 1 1 1 250 238 251 1 1 1 1 1 1 1 1 1
1 1 1 1 1 1 1 1 250 238 5 5 0 0 0 5 5 5 5 5 5 0 0 0 0 0 0 0 0 256 252 252 252 248 1 1 1 1 250 238 251 1 1 1 1 1 1 1 1 1
1 1 1 1 1 1 1 1 250 238 5 5 0 0 0 5 5 5 5 5 5 0 0 0 0 0 0 0 0 0 0 0 0 251 1 1 1 1 250 238 251 1 1 1 1 1 1 1 1 1
1 1 1 1 1 1 1 1 250 238 23 23 23 23 23 23 23 23 23 23 23 23 23 23 5 5 5 5 0 0 0 0 0 251 1 1 1 1 250 238 251 1 1 1 1 1 1 1 1 1
1 1 1 1 1 1 1 1 250 238 238 238 238 238 238 238 238 238 238 238 238 238 238 238 5 5 5 5 0 0 0 0 0 256 252 252 252 252 257 238 251 1 1 1 1 1 1 1 1 1
1 1 1 1 1 1 1 1 250 238 238 238 238 238 238 238 238 238 238 238 238 238 238 238 5 5 5 5 5 0 0 0 0 0 0 0 5 5 5 238 251 1 1 1 1 1 1 1 1 1
1 1 1 1 1 1 1 1 250 238 238 238 238 238 238 238 238 238 238 238 238 238 238 238 5 5 5 5 5 5 0 0 0 0 0 0 5 5 5 238 251 1 1 1 1 1 1 1 1 1
1 1 1 1 1 1 1 1 250 238 238 238 238 238 238 238 238 238 238 238 238 238 238 238 5 5 5 5 5 5 5 5 5 5 5 5 5 5 5 238 251 1 1 1 1 1 1 1 1 1
1 1 1 1 1 1 1 1 250 238 238 238 238 238 238 238 238 238 238 238 238 238 238 238 5 5 5 5 5 5 5 5 5 5 5 5 5 5 5 238 251 1 1 1 1 1 1 1 1 1
1 1 1 1 1 1 1 1 250 238 238 238 238 238 238 238 238 238 238 238 238 238 238 238 5 5 5 5 5 5 5 5 5 5 5 5 5 5 5 238 251 1 1 1 1 1 1 1 1 1
1 1 1 1 1 1 1 1 250 24 24 24 24 24 24 24 24 24 24 24 24 24 24 24 0 0 0 0 0 0 0 0 0 0 0 0 0 0 0 24 251 1 1 1 1 1 1 1 1 1
1 1 1 1 1 1 1 1 259 253 253 253 253 253 253 253 253 253 253 253 253 253 253 253 253 253 253 253 253 83 88 85 253 253 253 253 253 253 253 253 258 1 1 1 1 1 1 1 1 1
1 1 1 1 1 1 1 1 1 1 1 1 1 1 1 1 1 1 1 1 1 1 1 1 1 1 1 1 1 86 89 87 1 1 1 1 1 1 1 1 1 1 1 1 1 1 1 1 1 1
1 1 1 1 1 1 1 1 247 252 252 252 252 252 252 252 252 252 252 252 252 252 248 1 1 1 247 252 252 84 89 90 252 252 252 252 252 252 252 252 248 1 1 1 1 1 1 1 1 1
1 1 1 1 1 1 1 1 250 23 23 23 23 23 23 23 23 23 23 23 23 23 251 1 1 1 250 243 0 0 0 0 0 242 64 64 64 64 244 23 251 1 1 1 1 1 1 1 1 1
1 1 1 1 1 1 1 1 250 238 238 238 238 238 238 238 238 238 238 238 238 238 251 1 1 1 250 66 0 0 0 0 0 5 5 5 5 5 5 238 251 1 1 1 1 1 1 1 1 1
1 1 1 1 1 1 1 1 250 238 238 238 238 238 238 238 238 238 238 238 238 238 251 1 1 1 250 66 0 0 0 0 0 5 5 5 5 5 5 238 251 1 1 1 1 1 1 1 1 1
1 1 1 1 1 1 1 1 250 238 238 238 238 238 238 238 238 238 238 238 238 238 251 1 1 1 250 66 0 0 0 0 0 5 5 5 5 5 5 238 251 1 1 1 1 1 1 1 1 1
1 1 1 1 1 1 1 1 250 238 238 238 238 238 238 238 238 238 238 238 238 238 256 252 252 252 257 66 0 0 0 0 0 5 5 5 5 5 5 238 251 1 1 1 1 1 1 1 1 1
1 1 1 1 1 1 1 1 250 238 238 238 238 238 238 238 238 238 238 238 238 238 64 64 64 64 64 67 0 0 0 0 0 5 5 5 5 5 5 238 251 1 1 1 1 1 1 1 1 1
1 1 1 1 1 1 1 1 250 238 238 238 238 238 238 238 238 238 238 238 238 238 5 5 5 5 5 5 0 0 0 0 0 5 5 5 5 5 5 238 251 1 1 1 1 1 1 1 1 1
1 1 1 1 1 1 1 1 250 238 238 238 238 238 238 238 238 238 238 238 238 238 5 5 5 5 5 5 0 0 0 0 0 0 0 0 0 0 0 238 251 1 1 1 1 1 1 1 1 1
1 1 1 1 1 1 1 1 250 238 238 238 238 238 238 238 238 238 238 238 238 238 5 5 5 5 5 5 0 0 0 0 0 0 0 31 0 0 0 238 251 1 1 1 1 1 1 1 1 1
1 1 1 1 1 1 1 1 250 238 238 238 238 238 238 238 238 238 238 238 238 238 5 5 5 5 5 5 0 0 0 0 0 0 0 0 0 0 0 238 251 1 1 1 1 1 1 1 1 1
1 1 1 1 1 1 1 1 250 238 238 238 238 238 238 238 238 238 238 238 238 238 5 5 5 5 5 5 0 0 0 0 0 0 0 5 5 5 5 238 251 1 1 1 1 1 1 1 1 1
1 1 1 1 1 1 1 1 250 238 238 238 238 238 238 238 238 238 238 238 238 238 0 0 0 0 0 0 0 0 0 0 0 0 0 5 5 5 5 238 251 1 1 1 1 1 1 1 1 1
1 1 1 1 1 1 1 1 250 238 238 238 238 238 238 238 238 238 238 238 238 238 0 0 0 0 0 0 0 0 0 0 0 0 0 5 5 5 5 238 251 1 1 1 1 1 1 1 1 1
1 1 1 1 1 1 1 1 250 238 24 24 24 24 24 24 24 24 24 24 24 24 0 0 0 0 0 0 0 0 0 0 0 0 0 5 5 5 5 238 251 1 1 1 1 1 1 1 1 1
1 1 1 1 1 1 1 1 250 238 0 0 0 0 0 0 0 5 5 5 5 5 0 0 0 0 0 0 0 0 0 13 13 13 13 13 13 13 13 238 251 1 1 1 1 1 1 1 1 1
1 1 1 1 1 1 1 1 250 238 0 34 35 35 35 35 36 5 5 5 5 5 0 0 0 0 0 5 5 5 5 13 5 5 5 5 5 0 13 238 251 1 1 1 1 1 1 1 1 1
1 1 1 1 1 1 1 1 250 238 0 41 42 42 42 42 37 5 5 5 5 5 0 0 31 0 0 5 5 5 5 13 5 5 5 5 5 5 13 238 251 1 1 1 1 1 1 1 1 1
1 1 1 1 1 1 1 1 250 238 0 41 42 42 39 39 38 5 5 5 5 5 0 0 0 0 0 5 5 5 5 13 5 5 5 5 5 5 13 238 251 1 1 1 1 1 1 1 1 1
1 1 1 1 1 1 1 1 250 238 0 41 42 37 0 0 0 5 5 5 5 5 0 0 0 0 0 5 5 5 5 13 5 5 5 5 5 5 13 238 251 1 1 1 1 1 1 1 1 1
1 1 1 1 1 1 1 1 250 238 0 41 42 37 0 242 64 64 64 64 64 64 64 64 64 64 64 64 13 13 13 13 5 5 5 5 5 5 13 238 251 1 1 1 1 1 1 1 1 1
1 1 1 1 1 1 1 1 250 238 0 41 42 37 0 0 0 0 0 0 0 0 0 0 0 0 0 0 0 0 0 0 0 0 0 0 0 0 0 238 251 1 1 1 1 1 1 1 1 1
1 1 1 1 1 1 1 1 250 238 0 41 42 42 35 35 35 35 35 35 35 35 35 35 35 35 35 35 35 35 35 35 35 35 35 35 36 0 0 238 251 1 1 1 1 1 1 1 1 1
1 1 1 1 1 1 1 1 250 238 0 41 42 42 42 42 42 42 42 42 42 42 42 42 42 42 42 42 42 42 42 42 42 42 42 42 37 0 0 238 251 1 1 1 1 1 1 1 1 1
1 1 1 1 1 1 1 1 250 238 0 40 39 39 39 39 39 39 39 39 39 39 39 39 39 39 39 42 42 42 39 39 39 39 39 39 38 0 0 238 251 1 1 1 1 1 1 1 1 1
1 1 1 1 1 1 1 1 250 238 0 0 0 0 0 0 0 0 0 0 0 0 0 0 0 0 0 41 42 37 0 0 0 0 0 0 0 0 0 238 251 1 1 1 1 1 1 1 1 1
1 1 1 1 1 1 1 1 250 238 23 23 23 23 23 23 23 23 23 23 23 23 23 23 0 0 0 41 42 37 0 0 0 0 0 0 0 0 0 238 251 1 1 1 1 1 1 1 1 1
1 1 1 1 1 1 1 1 250 238 24 24 24 24 24 24 24 24 24 24 24 24 24 24 0 0 0 40 39 38 0 0 0 0 0 0 0 0 0 238 251 1 1 1 1 1 1 1 1 1
1 1 1 1 1 1 1 1 250 238 0 254 253 253 253 253 255 0 0 176 177 178 179 0 0 0 0 0 0 0 0 0 0 0 0 23 23 23 23 238 251 1 1 1 1 1 1 1 1 1
1 1 1 1 1 1 1 1 250 238 0 251 1 1 1 1 250 0 0 180 181 182 183 0 0 0 0 0 0 0 0 31 0 0 0 238 24 24 24 24 251 1 1 1 1 1 1 1 1 1
1 1 1 1 1 1 1 1 250 238 0 251 1 1 1 1 250 0 0 184 185 186 187 0 0 0 0 34 35 36 0 0 0 0 0 238 254 253 253 253 258 1 1 1 1 1 1 1 1 1
1 1 1 1 1 1 1 1 250 238 0 251 1 1 1 1 250 0 0 188 189 190 191 0 0 0 0 41 42 37 0 0 0 0 0 238 251 1 1 1 1 1 1 1 1 1 1 1 1 1
1 1 1 1 1 1 1 1 250 238 0 256 252 252 252 252 257 0 0 192 193 194 195 0 0 0 0 41 42 37 0 0 0 0 0 238 251 1 1 1 1 1 1 1 1 1 1 1 1 1
1 1 1 1 1 1 1 1 250 238 0 0 0 0 0 0 33 0 0 0 0 0 0 0 0 0 0 41 42 37 0 0 0 0 0 238 251 1 1 1 1 1 1 1 1 1 1 1 1 1
1 1 1 1 1 1 1 1 250 238 0 0 0 0 0 34 35 35 35 35 35 35 35 35 35 35 35 42 42 37 0 0 0 0 0 238 251 1 1 1 1 1 1 1 1 1 1 1 1 1
1 1 1 1 1 1 1 1 250 238 0 0 0 0 0 41 42 42 42 42 42 42 42 42 42 42 42 42 42 37 0 0 0 0 0 238 251 1 1 1 1 1 1 1 1 1 1 1 1 1
1 1 1 1 1 1 1 1 250 238 0 0 0 0 0 41 42 42 39 39 39 39 39 39 39 39 39 42 42 37 0 0 0 0 0 238 251 1 1 1 1 1 1 1 1 1 1 1 1 1
1 1 1 1 1 1 1 1 250 238 0 0 0 0 0 41 42 37 0 0 0 0 0 0 0 0 0 41 42 37 0 0 0 0 0 238 251 1 1 1 1 1 1 1 1 1 1 1 1 1
1 1 1 1 1 1 1 1 250 238 0 0 0 0 0 41 42 37 0 0 156 157 158 159 0 0 0 41 42 37 0 0 0 0 0 238 251 1 1 1 1 1 1 1 1 1 1 1 1 1
1 1 1 1 1 1 1 1 250 238 0 0 0 0 0 41 42 37 0 20 160 161 162 163 18 0 0 41 42 37 0 0 0 0 0 238 251 1 1 1 1 1 1 1 1 1 1 1 1 1
1 1 1 1 1 1 1 1 250 238 0 0 0 0 0 41 42 37 0 19 164 165 166 167 260 0 0 41 42 37 0 0 0 0 0 238 251 1 1 1 1 1 1 1 1 1 1 1 1 1
1 1 1 1 1 1 1 1 250 238 0 0 0 0 0 41 42 37 0 18 168 169 170 171 261 0 0 41 42 37 0 0 0 0 0 238 251 1 1 1 1 1 1 1 1 1 1 1 1 1
1 1 1 1 1 1 1 1 250 238 0 0 0 0 0 41 42 37 0 263 172 173 174 175 13 0 0 41 42 37 0 0 0 0 0 238 251 1 1 1 1 1 1 1 1 1 1 1 1 1
1 1 1 1 1 1 1 1 250 238 0 0 0 0 0 41 42 37 0 0 0 0 0 0 0 0 0 41 42 37 0 0 0 0 0 238 251 1 1 1 1 1 1 1 1 1 1 1 1 1
1 1 1 1 1 1 1 1 250 238 0 0 0 0 0 41 42 42 35 35 35 35 35 35 35 35 35 42 42 37 0 0 0 0 0 238 251 1 1 1 1 1 1 1 1 1 1 1 1 1
1 1 1 1 1 1 1 1 250 238 0 0 31 0 0 41 42 42 42 42 42 42 42 42 42 42 42 42 42 37 0 0 0 0 0 238 251 1 1 1 1 1 1 1 1 1 1 1 1 1
1 1 1 1 1 1 1 1 250 238 0 0 0 0 0 40 39 39 39 39 42 42 42 39 39 39 39 39 39 38 0 0 0 0 0 238 251 1 1 1 1 1 1 1 1 1 1 1 1 1
1 1 1 1 1 1 1 1 250 238 0 0 0 0 0 0 0 0 0 0 41 42 37 0 0 0 0 0 0 0 0 0 0 0 0 238 251 1 1 1 1 1 1 1 1 1 1 1 1 1
1 1 1 1 1 1 1 1 250 238 0 0 0 0 0 0 0 0 0 0 41 42 37 0 0 0 0 0 0 0 0 0 0 0 0 238 251 1 1 1 1 1 1 1 1 1 1 1 1 1
1 1 1 1 1 1 1 1 250 238 0 0 0 0 136 137 138 139 0 0 41 42 37 0 0 136 137 138 139 0 0 0 0 0 0 238 251 1 1 1 1 1 1 1 1 1 1 1 1 1
1 1 1 1 1 1 1 1 250 238 0 0 0 0 140 141 142 143 21 0 41 42 37 0 0 140 141 142 143 19 0 0 0 0 0 238 251 1 1 1 1 1 1 1 1 1 1 1 1 1
1 1 1 1 1 1 1 1 250 238 0 0 0 0 144 145 146 147 18 0 41 42 37 0 0 144 145 146 147 20 0 0 0 0 0 238 251 1 1 1 1 1 1 1 1 1 1 1 1 1
1 1 1 1 1 1 1 1 250 238 0 0 0 0 148 149 150 151 260 0 41 42 37 0 0 148 149 150 151 260 0 31 0 0 0 238 251 1 1 1 1 1 1 1 1 1 1 1 1 1
1 1 1 1 1 1 1 1 250 238 0 0 0 263 152 153 154 155 261 0 41 42 37 0 263 152 153 154 155 261 0 0 0 0 0 238 251 1 1 1 1 1 1 1 1 1 1 1 1 1
1 1 1 1 1 1 1 1 250 238 0 0 0 0 0 0 0 0 0 0 41 42 37 0 0 0 0 0 0 0 0 0 0 0 0 238 251 1 1 1 1 1 1 1 1 1 1 1 1 1
1 1 1 1 1 1 1 1 250 238 0 0 34 35 35 35 35 35 35 35 42 42 42 35 35 35 35 35 35 35 35 35 36 0 0 238 251 1 1 1 1 1 1 1 1 1 1 1 1 1
1 1 1 1 1 1 1 1 250 238 0 0 41 42 42 42 42 42 42 42 42 42 42 42 42 42 42 42 42 42 42 42 37 0 0 238 251 1 1 1 1 1 1 1 1 1 1 1 1 1
1 1 1 1 1 1 1 1 250 238 0 0 40 39 39 39 39 39 39 39 39 39 39 39 39 39 39 39 39 39 39 39 38 0 0 238 251 1 1 1 1 1 1 1 1 1 1 1 1 1
1 1 1 1 1 1 1 1 250 238 0 0 0 0 0 0 0 0 0 0 0 0 0 0 0 0 0 0 0 0 0 0 0 0 0 238 251 1 1 1 1 1 1 1 1 1 1 1 1 1
1 1 1 1 1 1 1 1 250 24 0 0 0 0 0 0 0 0 0 0 0 0 0 0 0 0 0 0 0 0 0 31 0 0 0 24 251 1 1 1 1 1 1 1 1 1 1 1 1 1
1 1 1 1 1 1 1 1 259 253 253 253 253 253 253 253 253 253 253 253 253 253 253 253 253 253 253 253 253 253 253 253 253 253 253 253 258 1 1 1 1 1 1 1 1 1 1 1 1
1 1 1 1 1 1 1 1 1 1 1 1 1 1 1 1 1 1 1 1 1 1 1 1 1 1 1 1 1 1 1 1 1 1 1 1 1 1 1 1 1 1 1 1 1 1 1 1 1 1
1 1 1 1 1 1 1 1 1 1 1 1 1 1 1 1 1 1 1 1 1 1 1 1 1 1 1 1 1 1 1 1 1 1 1 1 1 1 1 1 1 1 1 1 1 1 1 1 1 1
1 1 1 1 1 1 1 1 1 1 1 1 1 1 1 1 1 1 1 1 1 1 1 1 1 1 1 1 1 1 1 1 1 1 1 1 1 1 1 1 1 1 1 1 1 1 1 1 1 1
1 1 1 1 1 1 1 1 1 1 1 1 1 1 1 1 1 1 1 1 1 1 1 1 1 1 1 1 1 1 1 1 1 1 1 1 1 1 1 1 1 1 1 1 1 1 1 1 1 1
1 1 1 1 1 1 1 1 1 1 1 1 1 1 1 1 1 1 1 1 1 1 1 1 1 1 1 1 1 1 1 1 1 1 1 1 1 1 1 1 1 1 1 1 1 1 1 1 1 1
1 1 1 1 1 1 1 1 1 1 1 1 1 1 1 1 1 1 1 1 1 1 1 1 1 1 1 1 1 1 1 1 1 1 1 1 1 1 1 1 1 1 1 1 1 1 1 1 1 1
1 1 1 1 1 1 1 1 1 1 1 1 1 1 1 1 1 1 1 1 1 1 1 1 1 1 1 1 1 1 1 1 1 1 1 1 1 1 1 1 1 1 1 1 1 1 1 1 1 1